..........
........@.
#.#.#.#.#.
##...#....
...#...#..
..#..#....
X..#......
.#........
..#.......
..........