...#.X#...
...###....
...#......
#.........
.#........
#..###....
....@#....
..........
..........
..........